-lr-t-lr--|-lr-----t-
----b-----|---lhr--b-
----------|----------
--t--lhhr-|------lhr-
--v-------|--lhr-----
--v-lhhr--|t---------
--v------t|v-t--lhhr-
--b-lhr--b|v-v-------
----------|v-v--t-lr-
lhr-lhr---|b-b--b----
