-t-lhhr---|-lr---lr--
-v--------|---lhr----
-b-t-lhr--|------t--t
---v------|t-lr--v--v
---b-lr-lr|v-----v--v
-t--t-----|b-----b--v
-b--v-----|---------b
----v-lhhr|---lhhr---
-lr-v-----|t---------
----b-----|b---lhr---