-t-----lhr|-lhr----lr
-v-t-t----|t----t----
-v-b-b----|b----b----
-b--------|--t------t
----lhhhr-|--v-t--t-v
lr--------|--v-v--v-b
-----lr-t-|--v-b--v--
--------v-|--b----b--
---lhr--v-|--------t-
lhr-----b-|--lhhr--b-