lhhr--t---|----lhhr--
------v-t-|t---------
t-t---b-b-|v-t-t---t-
v-b-------|v-v-b---v-
b-----t--t|v-b---t-v-
---t--b--v|b---t-v-b-
t--v---t-v|----b-b---
b--v---v-v|t-t-----t-
---b---b-b|v-b-----b-
----------|b---------