-lr---t---|--------t-
---t--b---|lhr-t-t-v-
lr-v-t-t--|----b-v-v-
---v-b-v--|------v-b-
-t-v---v--|---lr-b--t
-v-b---b--|--t--t---v
-b--------|--b--v---b
---lhr----|-----b----
------lhr-|------lr--
--lhhr----|lhhhr-----