----lhhhr-|--t---lhhr
----------|--v--t----
---t------|--v--b----
lr-v-lhhr-|--b-----lr
---b------|----------
--------lr|--t----lhr
lhr---lr--|--v-t-----
--------t-|t-v-v-lr--
-t-lhhr-v-|v-v-b---t-
-b------b-|b-b-----b-