---t------|t---------
t--v--t---|b---------
b--v--v---|----lhr---
---b--b---|--t----lhr
lhr-t--lr-|--v-t-----
----v-----|t-v-v-lhhr
lr--b-lhhr|v-v-v-----
----------|b-b-b--lr-
------lr--|---t------
-lhhhr----|---b--lr--