t--lr-----|--t-----t-
v---------|t-b--t--v-
v------lhr|v----b--v-
b---t-----|v-------b-
----v--t-t|v----lhr-t
t-t-v--b-v|b--t-----b
b-b-b----b|-t-v-lhr--
----------|-v-b----t-
------lhr-|-v------b-
-lhhhr----|-b--------