----------|----lhr-lr
t----lhr-t|-t-t------
b--------v|-b-v---t--
-lhhr--t-v|---b---v-t
-------v-v|-t-----b-v
-t-t---v-b|-v-t--t--v
-v-b---b--|-v-v--b--b
-b--------|-v-v------
-----lr---|-b-b------
---lr--lhr|-----lr---