-------t--|----------
---lr--v--|lhhhr-t---
-t---t-v--|------v-t-
-v---b-v--|lr----b-b-
-v-----b--|----------
-b-lr----t|t-----lhhr
t--------b|v-lr------
v----lhr--|b---lhhr-t
v-lhr-----|--t------v
b------lhr|--b------b