------lhr-|---------t
-lhhhr----|-lhhr----b
----------|-----lhhr-
---lhr-lr-|-lr------t
lhr-------|---------b
---lr--t--|t-lhr-t---
--t----v-t|v-----v---
--b-t--v-v|v-----b---
----b--b-v|v---lr-lhr
---------b|b---------