----------|---lhr-t--
t--lr-t---|-------b--
b-----v-t-|-lhhhr--lr
-lhhr-v-v-|------t---
t-----v-b-|t-----v---
v-lhr-b---|b-----v---
v------lhr|------b--t
b---t-----|---lhr---v
----b--lr-|-lr------b
----------|----lhhr--