--t-------|---lhhr---
--b-lr--t-|-lr-------
--------b-|----lhr-t-
--t-lhhr--|--------b-
--v-------|-------t--
t-v---lhhr|t-lhr--v--
v-v-------|v------v--
b-b-lhr---|v------b--
----------|v-t-------
--lr-lhr--|b-b-lr-lhr