----------|----lhhhr-
----lr----|----------
-------lr-|--lhr--t--
t---t----t|-------b--
v-t-v----v|-t-------t
v-v-b----v|-b-lhr---v
v-b---t--b|t--------b
b---t-v-t-|v---lhhr--
-lr-v-v-b-|v---------
----b-b---|b--lr-lr--