-t--------|-t---lhhhr
-v-lr-----|-b--------
-b---lhhhr|--lhhr-lhr
----------|lr----t---
-t--lhr-lr|------b---
-v--------|t------t--
-v--t--lr-|v--t---b--
-b--v-----|b--v------
t---v--lhr|---b------
b---b-----|-----lhhr-